Status	Comments
Late work and communication issues	Yes/No	No issues
Code available in GitHub	Yes/No	Yes
Apk available at the root	Yes/No	Yes
Screenshots available at the root	Yes/No	Yes
The app crashes	Yes/No	No
Min SDK 	?	21
Target SDK	?	30
App tested	On phone / on emulator / both	On emulator
SMS (button) – correct behavior 	Yes/No	Yes
Phone (button) – correct behavior	Yes/No	Yes
Web (button) – correct behavior	Yes/No	Yes
Map (button) – correct behavior	Yes/No	Yes
Share (button) – correct behavior	Yes/No	Yes
New Activity (button) – correct behavior	Yes/No	Yes
Help (button) – correct behavior	Yes/No	Yes
About (menu) – correct behavior	Yes/No	Yes
Settings (menu) – correct behavior	Yes/No	Yes
Image in at least 6 different format	Yes/No	Yes
General comments about the app	
Nice job!
